R 1280 720
SO textures/purplestone.xpm
EA textures/wall_3.xpm
NO textures/eagle.xpm
WE textures/wall_2.xpm
S textures/fatbitch.xpm
C 51,153,255
F 80,80,80

        1111111111111111111111111
        1000000000110000000000001
        1011000001110000002000001
        1001000000000000000000001
111111111011000001110000000000001
100000000011000001110111111111111
11110111111111011100000010001
11110111111111011101010010001
11000000110101011100000010001
10002000000000001100000000201
10000000000000000001010010001
11000001110101011111011110S0111
11110111011101010101111010001
11111111111111111111111111111