R 1920 1080
SO textures/purplestone.xpm
EA textures/wall_3.xpm
NO textures/eagle.xpm
WE textures/wall_2.xpm
S textures/fatbitch.xpm
C 51,80,40
F 80,80,80

11111111111111111111
10000000000001000001
10000000000001000001
10000000000001000001
11111111110001000001
         10000000001
         10000000001
         11111001111
         10000000001
         10000000001111111111111
         10000000200002000000001
         10000000000000000000001
         10000000200W00000000001
         10002000000002000000001
         10000000000000000000001
         11111111111111111111111