R 640 680
SO textures/purplestone.xpm
EA textures/wall_3.xpm
NO textures/eagle.xpm
WE textures/wall_2.xpm
S textures/fatbitch.xpm
C 51,98,132
F 80,80,80


1111111111111111111111111111
1000000000000100000000000001
1000020000000100000020000001
1000000000000000000000000001
11111111111000N0011111111111
1000000000000000000000000001
1000002000000010000002000001
1000000000000010000000000001
1111111111111111111111111111
           111111
           100001
           100001
           111111