R 1280 720
SO textures/purplestone.xpm
EA textures/wall_3.xpm
NO textures/iceage.xpm
WE textures/chipmonk.xpm
S textures/fatbitch.xpm
C 51,110,140
F 80,10,60


1111111111111111111111
1000000000000000000001
1000000020002000200001
11111100000000000000011111
     100000000000000000001
     100000000000000000001
     1111111100000000000011111
            100000000000000001
            10000000S000000001
     1111111100000000000011111
     100000000000000000001
     100000000000000000001
11111100000000000000011111
1000000020020200000001
1000000000000000000001
1111111111111111111111